. . . # . . # . . . . .
# # # # . . # . . . . .
. * * * * . # . . . # .
* . * . . # # # # # . .
* . * # # . # ~ . * . .
* . * # . . # ~ . * . .
* . * # . . # ~ . * . .
* . * # . . # ~ . * . .
. . * # . . # ~ . . . .
. . * # . . # ~ . . . .
. . . . . . # ~ . . . .
. . . . . . . ~ . . . .
